111111111111111111111111
100000000100000000000001
101110010001100000111001
100011111111100000001001
111010010010000000111001
100011110010000000100001
100000010010000000101001
101111110000000000101001
100000010000000000101111
101001111110000000100001
101000000010000000100001
101111110011111000100001
101000000010000000111001
101111111110000000101001
100000010000000000101001
111110010001111000001001
100000000001001111001001
100000000001000001001001
111110000001000001001001
100000001111001000001001
100100001000001001111001
111100001111001000000001
100001000001001000000001
111111111111111111111111
